FwdPrimer	RevPrimer
GTCCTTGCCAATGAACGGGG	TTCAAGACGGGCGTGACTGC
GCCCCCGACATCGTCAAAAC	AGGCCGGCTCTGCATTGTTC
CCATGCGTTAGTTCGTGGCG	GCGATTTTGACACCCCGTCC
TGAGGCACGGCAATCAGAGG	TATGACCCCATCCGGAGACC
ATCCAGCGCGACAACGTCAG	CTGCAAACATCCGGTTCGGG
TCGCAGCCAAGGACATCGAC	AATGTTGGCAGGTGCACTCC
TTTGGCAGCGTGTCCCTCAG	CCGGTATTGATTCGCCCAGC
CGATTCCCACACAACACGCC	TTCTCGGTGAGCACGCAACC
TCGTGAAGGAGCCGAAAGGG	TGCAGTGCCAGAGGGTTTGC
TCCTGGCATCACAGCTTCGG	TCCGATCGAGACAGCAACGG
CGGGCACCATGATTCGTGAC	GTCCCTGGCCGATCATTTGG
CGCGGTTTACAAGGCTTCCG	GTTTCGTAGCCGCCGGTTTG
TTGCACGCGACTCCCTCAAC	CCATCAGCGCATTTGGCAAC
TGCTGACGACATCGGGCTTC	TCGCCTGATGGACCAGCATC
TGTCGAACGTTGGCTCTGGC	CGAACGACCCGGGATTTCAG
TGTCAGGCTTTGTCGCCGTC	ACGTCAGAGCGGACATTGCG
GCCTTGCGATTGGAAAACCG	GGTTGTGCATCGGTTCGGTG
TTATCTCTTCGGCGGCGAGC	CCGAAACACGCGCATTCATC
GCCACGGCACGTACATAGAA	CACGATTCCCCGGTTCGTTC
CGTAGGCGGGGTCAAATCTC	CCACGTGTCACCATGATGCG
AGGTCGGCCAGTGTTATTTG	CACTGGCGCAATGCGAAAAC
GTAAGTAACCAATCGGTGCT	GGATCTCGTCCCGTCAATGT